11111111111111111111111111111111111
1E0000000000000C00000C00P0000000011
11111111111111111111111111111111111