11111111111111111111111111111111111
10000000000000000000000000000000001
1000000000000E000000000000000000001
10000000000000000000000000000000001
10000000C000000000000C0000000000001
100000000000000000P0000000000000001
10000000000000000000000000000000001
11111111111111111111111111111111111