11111111111111111111111111111111111
1E00P0000000000C00000C0000000000011
11111111111111111111111111111111111
1E0000000000000C00000C0000000000011
1010010100100000101001000P000101011
10100100101010100010010000000101011
100000000C00C00000000E0000000000C11
11111111111111111111111111111111111
11111111111111111111111111111111111