11111111111111111111111111111111111
1E0000000000000C00000C000P000000011
10100101001000001010010000000101011
10100100101010100010010000000101011
100000000C00C0000000000000000000C11
11111111111111111111111111111111111
11111111111111111111111111111111111