11111111111111111111111111111111111
1EC0000000E00000000000P000000000001
11111111111111111111111111111111111