1111111111111111111111111111111111111111
100000000000000C000000C0000000C000000001
1000000000000EC000000P000000000000000001
1000C0000CC00000000000000000P00000000001
1111111111111111111111111111111111111111